R 800 600
NO ./srcs/images/ft_textures/wall_n.xpm
SO ./srcs/images/ft_textures/wall_s.xpm
WE ./srcs/images/ft_textures/wall_w.xpm
EA ./srcs/images/ft_textures/wall_e.xpm
S ./srcs/images/origin_textures/sprite_1.xpm
F 139,99,49
C 60,194,255

1111111111111
1000000000001
1000000011111
100000E000001
1001000002001
1001000002001
1001000002001
1111111111111

