R 500 500
NO ./srcs/textures/wall_n.xpm
WE ./srcs/textures/wall_w.xpm
S ./srcs/textures/sprite_1.xpm
SO ./srcs/textures/wall_s.xpm
EA ./srcs/textures/wall_e.xpm
F 139,99,49
C 60,194,255

    1111111111111
    1000000000001
    100000011111
1111100000001
10010000022201
1001000002201
10010000022201
10000000000001
10000000000001
1000000N000011
10000000000021
1000000000011
10000000000001
10000000000001
10000000000001
10000000000001
10000000000001
10000000000001
10000000000001
10000000000001
10000000000001
10000000000001
11111111111111




11111111
10021
11111111
